111111111111111111111111111111111111111111111111111111111111
100000000000000000000000000000000000000000CCCCCCCCC000000001
100100100100001000001110001111100000000000000000000000000001
1001001001000010000100000100000100000000000000CCCCCCCCC00001
100111100100001000010000010000010000000000000000000000000001
10010010010000100001011001000001000000000000CCCCCCCCC0000001
100100100100001000010010010000010000000000C00000000000000001
100100100011110000001110010000010000000000000CCCCCCCCC000001
100000000000000000000000001111000000000000000000CCCCCCCCC001
1P00000C00000000E0000000000000000000000000000000000000000001
111111111111111111111111111111111111111111111111111111111111
