1111111111111111111111111111111111111111111111111111111111111111111111111111111111111111111111111111111111111111111111111111111111111111111111111111111111111111111111111111111111111111111111111111111111111111111111111111111111111111111111111111111111111111111111111111111111111111111111111111111111111111111111111111111111111111111111111111111111111111111111111111111111111111111111111111111111111111111111111111111111111111111111111111111111111111111111111111111111111111111111111111111111111111111111111111111111111111111111111111111111111111111111111111111111111111111111111111111111111111111111111111111111111111111111111111111111111111111111111111111111111111111111111111111111111111111111111111111111111111111111111111111111111111111111111111111111111111111111111111111111111111111111111111111111111111111111111111111111111111111111111111111111111111111111111111111111111111111111111111111111111111111111111111111111111111111111111111111111111111111111111111111111111111111111111111111111111111
1P00000C000C00000C000C00000C000C00000C000C00000C000C00000C000C00000C000C00000C000C00000C000C00000C000C00000C000C00000C000C00000C000C00000C000C00000C000C00000C000C00000C000C00000C000C00000C000C00000C000C00000C000C00000C000C00000C000C00000C000C00000C000C00000C000C00000C000C00000C000C00000C000C00000C000C00000C000C00000C000C00000C000C00000C000C00000C000C00000C000C00000C000C00000C000C00000C000C00000C000C00000C000C00000C000C00000C000C00000C000C00000C000C00000C000C00000C000C00000C000C00000C000C00000C000C00000C000C00000C000C00000C000C00000C000C00000C000C00000C000C00000C000C00000C000C00000C000C00000C000C00000C000C00000C000C00000C000C00000C000C00000C000C00000C000C00000C000C00000C000C00000C000C00000C000C00000C000C00000C000C00000C000C00000C000C00000C000C00000C000C00000C000C00000C000C00000C000C00000C000C00000C000C00000C000C00000C000C00000C000C00000C000C00000C000C00000C000C00000C000C00000C000C00000C000C00000C000C00000C000C00000C000C00000C000C00000C000C00000C000C00000C000C00000C000C00000C000C00000CE1
1111111111111111111111111111111111111111111111111111111111111111111111111111111111111111111111111111111111111111111111111111111111111111111111111111111111111111111111111111111111111111111111111111111111111111111111111111111111111111111111111111111111111111111111111111111111111111111111111111111111111111111111111111111111111111111111111111111111111111111111111111111111111111111111111111111111111111111111111111111111111111111111111111111111111111111111111111111111111111111111111111111111111111111111111111111111111111111111111111111111111111111111111111111111111111111111111111111111111111111111111111111111111111111111111111111111111111111111111111111111111111111111111111111111111111111111111111111111111111111111111111111111111111111111111111111111111111111111111111111111111111111111111111111111111111111111111111111111111111111111111111111111111111111111111111111111111111111111111111111111111111111111111111111111111111111111111111111111111111111111111111111111111111111111111111111111111111
