11111111111111111111111
1C00000000000100C010001
10000000000000000101101
1101110000111100C100001
1E000000001111000011111
1111111100011100P000001
1C000000000001000000001
10000000000001000000001
11011100001111000000001
10000000000C000000C0001
11111111111111111111111
