1111111111111
1CCCC00000001
1000000000001
1000000000001
10000E0000001
1000000000001
1P00000000001
1111111111111
