11111111111111111111111111111111111111111111111111111111111111111111111111111111111111111111111111111111111111111111
1C0000000CC000000000CC000000000CC000000000CC000000000CC000C0000000CC000000000CC000000000CC000000000CC000000000CC0001
1P00000C00000000E00000000000000000000000000000000000000000C0000000CC000000000CC000000000CC000000000CC000000000CC0001
11111111111111111111111111111111111111111111111111111111111111111111111111111111111111111111111111111111111111111111
