111111111111111111111111111111111111111111111111111111111111
1C0000000CC000000000CC000000000CC000000000CC000000000CC00001
1C0000000CC000000000CC000000000CC000000000CC000000000CC00001
1C0000000CC000000000CC000000000CC000000000CC000000000CC00001
1C0000000CC000000000CC000000000CC000000000CC000000000CC00001
1C0000000CC000000000CC000000000CC000000000CC000000000CC00001
1C0000000CC000000000CC000000000CC000000000CC000000000CC00001
1C0000000CC000000000CC000000000CC000000000CC000000000CC00001
1C0000000CC000000000CC000000000CC000000000CC000000000CC00001
1C0000000CC000000000CC000000000CC000000000CC000000000CC00001
1C0000000CC000000000CC000000000CC000000000CC000000000CC00001
1C0000000CC000000000CC000000000CC000000000CC000000000CC00001
1C0000000CC000000000CC000000000CC000000000CC000000000CC00001
1C0000000CC000000000CC000000000CC000000000CC000000000CC00001
1C0000000CC000000000CC000000000CC000000000CC000000000CC00001
1C0000000CC000000000CC000000000CC000000000CC000000000CC00001
1C0000000CC000000000CC000000000CC000000000CC000000000CC00001
1C0000000CC000000000CC000000000CC000000000CC000000000CC00001
1C0000000CC000000000CC000000000CC000000000CC000000000CC00001
1C0000000CC000000000CC000000000CC000000000CC000000000CC00001
1C0000000CC000000000CC000000000CC000000000CC000000000CC00001
1C0000000CC000000000CC000000000CC000000000CC000000000CC00001
1C0000000CC000000000CC000000000CC000000000CC000000000CC00001
1C0000000CC000000000CC000000000CC000000000CC000000000CC00001
1C0000000CC000000000CC000000000CC000000000CC000000000CC00001
1C0000000CC000000000CC000000000CC000000000CC000000000CC00001
1C0000000CC000000000CC000000000CC000000000CC000000000CC00001
1P00000C00000000E0000000000000000000000000000000000000000001
111111111111111111111111111111111111111111111111111111111111
