111111111111111111111111111
1E0C0000C0000C0000000000001
100000C0000P000000000000001
100001111110000000000000001
100001111110000000000000001
100001111110000000000000001
100001111110000000000000001
100001111110000000000000001
100001111110000000000000001
111111111111111111111111111