11111111111
1EPC0001001
10000000C01
11111101011
11111111111