1111111111111111111111111111111111111111
10000100010000000000000000000000000011C1
1011000100011111101111011101111111101101
101111111111111C101C10001001111111101101
1000000000000E10101010P01011111111101101
1111111111111110101011111001100000101101
10000000000C1000100000001101100000101101
1011111111101010101000111101100C00001101
1010000000101010101000001101100000101101
1011111111101110101010011001100000101101
1000000000000000101111011101111111101101
1111011111111110100010000001111111101101
1111000000000C10000000000001111111101101
1111111111111111111110111111111111101101
1111111111111111111110111111111111101101
1110001000100010001C100100C1C00000100001
1000100010001000100010000111110100100001
1011111011111111111110010001000100100001
10000C1000000000000000010000000100000001
1111111111111111111111111111111111111111